##########
#........#
######...#
#........#
#..#######
#........#
#######..#
#........#
#........#
####__####